11111111111111111111
10000000000B00000001
10000000C00000000E01
10000100000011111111
1P000000000001110C11
11111111111011110111
10000000000000000001
1000000000CC00000001
10000000000000000001
11111111111111111111