11111111111111111111
1000000A000B00000001
10000000C00000000E01
1000A10A000011111111
1P000000000001110C11
10000000000B11110111
100A0000000000000001
10000000A0CC00000001
100000000000000A0001
11111111111111111111