11111111111111111111
100000000A0000000001
100000111111111111C1
1CCC11111A00000E1111
10000B0000001111CCC1
10000000000000000001
100000B0000CCC0A0CC1
1000000000000A000001
111111P1111000000001
11111111111111111111