1111111
1000001
1PEC111
1000001
1000001
1111111