111111111111111111111111
1000Z0000000000000000001
10000000C00000000E000001
100001000000111111111111
1P0000000000011111111111
111111111111111111111111