111111111111111111111111
100000000000000000000001
10000000C00000000E000001
100001000000111111111111
1P0000000000011111111110
111111111111011111111111