111111111111111111111111
100000000000000000000001
10000000000000000E000001
100001000000111111111111
100000C00000011111111111
111111111111111111111111