111111111111111111111111
100000000000000000000001
10000000C00000000E000001
100001000000111111111111
1P00000000000111
1111111111111111